24
9
100000000001100000000001
110000000001100000000011
11000c00001111000d000011
100001100000000001100001
100011000000000000110001
100000000100001000000001
110000000100001000000011
1110a00011222211000b0111
111111111111111111111111