16
12
2000000000000002
2000000000000002
2000022222200002
2000000000000002
2000000000000002
2222000000002222
1000000000000001
1000000000000001
1100001111000011
111a00000000b111
111100c00d001111
1111111111111111