10
10
2000000002
2000000002
2000000002
2000000002
2001221002
2a000000b2
1100000011
2001111002
2c000000d2
1111111111